[
    {
        "name": "empty",
        "mapData": [
            "######++######",
            "#............#",
            "#............#",
            "#............#",
            "+............+",
            "#............#",
            "#............#",
            "#............#",
            "######++######"
        ],
        "charToTileType": {
            "#": "wall",
            ".": "floor",
            "+": "door"
        },
        "doors": "restricted"
    },
    {
        "name": "test1",
        "mapData": [
            "######++######",
            "#............#",
            "#.####..####.#",
            "#.#........#.#",
            "+............#",
            "#.#........#.#",
            "#.#........#.#",
            "#.####..####.#",
            "#............#",
            "######++######"
        ],
        "charToTileType": {
            "#": "wall",
            ".": "floor",
            "+": "door"
        },
        "doors":"strict"
    }
]
